111111111111111
1CCCCPCCCCCCCC1
111111111111111