111111111111111
10C0010C01000C1
10P001010100N01
10C001C0010EN01
10C00N00C000001
111111111111111