111111111111111
10C000000000001
10P000000000001
10C00000000E001
10C000000000001
111111111111111