111111111111111
10C0010C01000C1
10P001010100001
10C001C0010E001
10C00000C000001
111111111111111