111111111111
10E000000001
1000P0000001
1000C0000001
100000000001
111111111111
