111111111111
1C1000CC0001
1011100C0001
1P00E0000001
10CCC000C001
111111111111