111111111111
10E000000001
100000000001
100C00000001
10000000P001
111111111111