111111111111
1C000C0C0001
100C00000001
1P00C0000E01
1000000C0001
111111111111