11111111111
10CP0101EC1
11111111111
1C000000011
11111111111