11111111111111111111
11111111111111111111
10E00000000000000001
10000000000000000001
100C0000000000000001
100C0000000000000001
10000P00000000000001
10000000000000000001
11111111111111111111
11111111111111111111
11111111111111111111